#
# 0 D room1.txt 0
#
WWWW0WWWWW
W        W
W    W   W
W   WW   W
W    W   W
W    W   W
W    W   W
W   WWW  W
W        W
WWWWWWWWWW
