#
# 0 E room1.txt 0
#
WWWW0WWWWW
WWWW WWWWW
WWWW WWWWW
WWWW WWWWW
WWWW WWWWW
WWWW WWWWW
WWW   WWWW
WW  c   WW
WW      WW
WWWWWWWWWW