#
# 0 E room1.txt 0
# 1 D room8.txt 3
#
WWWWWWWWWW
1        W
WWWWWWWW W
WGGGGGGGGW
WGGGGkGGGW
WWWGGGGGGW
WWGGGGGGGW
WGGGGGGGGW
WWWWW WWWW
WWWWW0WWWW