#
# 0 E room1.txt 1
# 1 D room2.txt 0
#
WWWW0WWWWW
W        W
W  S   m W
WWWWW  S W
W   W    W
W   W  WWW
W        W
W        W
1      e W
WWWWWWWWWW
