#
# 0 E room1.txt 1
# 1 D room6.txt 0
#
WWWW0WWWWW
WGG    GGW
W  WWW   W
W     W  W
W  WWW   W
W W    m W
W W  GGG W
W  WWWW  W
1      GGW
WWWWWWWWWW
